
אא - אשל אברהם
אי - ארץ ישראל
אכ - אם כן
אר - אליה רבה
אבד - אב בית דין
אבנז - אבני נזר
אגמ - אגרות משה
אדמור - אדוננו מורנו ורבנו
אדמוהז - אדמור הזקן (חבד)
אדרת - הרב אליהו דוד רבינוביץ' תאומים
אהע - אבן העזר
אוז - אור זרוע
אוח - אורח חיים, אורחות חיים
אולצ - אור לציון
אחכ - אחר כך 
אעג - אף על גב
אעפ - אף על פי
ארי - רבי יצחק אשכנזי (לוריא)
אשי - אשי ישראל 
בב - בבא בתרא
בח - בית חדש
בי - בית יוסף 
בי ובי - בל יראה ובל ימצא
במ - בבא מציעא
בק - בבא קמא
באח - בן איש חי
באהט - באר היטב
באוה - באור הלכה
בדהש - בדי השולחן 
בהג - בעל הלכות גדולות
ביהש - בין השמשות
ביהכנ- בית הכנסת
ביהמד - בית המדרש
ביהשמ - בין השמשות 
בכורי - ביכורי יעקב
במדר – במדבר רבה
בעהב - בעל הבית
בעזה - בעזרת ה'
בראר - בראשית רבה
ברהמז - ברכת המזון
ברכה- ברכת ה'
ברכי - ברכי יוסף
ברכהש - ברכות השחר
ברכהת - ברכות התורה 
גמ - גמרא
גרא - הגאון רבי אליהו (מווילנא)
גרז - גאון ר' זלמן, מחבר שוע הרב
גרז - גאון ר' זלמן, מחבר שוע הרב 
גרעי - גאון ר' עובדיה יוסף
גשהח - גשר החיים
דא - ד' אמות 
דה - דבור המתחיל
דמ - דרכי משה 
דר - דוקטור
דת - דברי תורה 
דבר - דברים רבה
דגמ - דגול מרבבה
דהח - דרך החיים 
דרכת - דרכי תשובה
ה - הלכה 
הבי - הגהות בית יוסף
הגבי - הגהות בית יוסף
הגהט - הגהות הטור
הגהמ - הגהות מימוניות 
הגהמ (הגמי) - הגהות מימוניות 
הדט – הצעיר דניאל טירני
ההמ - הרב המגיד (מגיד משנה)
הל – הלכה, הלכות 
הלחב – הלכות חג בחג
הנציב - הרב נפתלי צבי יהודה ברלין
הקבה - הקדוש ברוך הוא
הקבה – הקדוש ברוך הוא
הראשלצ - הראשון לציון
הרציה - הרב צבי יהודה הכהן קוק
ויקר - ויקרא רבה
וככ - וכן כתב
זא - זעיר אנפין.
זל - זה לשונו
זוהח - זוהר חדש 
זצל - זכר צדיק לברכה
ח - חלק 
חא - חיי אדם, חלק א
חוי - חוות יאיר
חול - חוץ לארץ
חומ - חושן משפט
חוהמ - חול המועד
חוהמכ - חול המועד כהלכתו
חזל - חכמינו זכרונם לברכה 
חזוא - חזון איש 
חזוע – חזון עובדיה
חידא - רבי חיים יוסף דוד אזולאי
חכא - חכמת אדם
חכצ - חכם צבי
חסל - חסד לאלפים
חרלפ - חייא ראש לגולי פולין (שם משפחה)
חתס - חתם סופר
חתס - חתם סופר 
טז - טורי זהב 
טוטוד - טוב טעם ודעת
יא - יש אומרים 
יביא - יביע אומר
יוד - יורה דעה 
יוט - יום טוב 
יוכ - יום כיפור
יוהכ - יום הכיפורים
יחוד - יחוה דעת 
ייש - יין שרף
ילקוי - ילקוט יוסף 
ילקוש - ילקוט שמעוני
יסוהת - (הל') יסודי התורה
יעבץ - יעקב בן ציון
ישש - ים של שלמה 
ככ - כן כתב
כץ - כהן צדק 
כהח - כף החיים 
כוע - כולי עלמא 
כנל - כנראה למעלה 
כנהג - כנסת הגדולה
כסמ - כסף משנה
כתס - כתב סופר
לפז - לפי זה
לפיז - לפי זה 
מא - מגן אברהם
מב - משנה ברורה 
מז - משבצות זהב
ממ - מכל מקום, מגיד משנה 
מאכא - (הל') מאכלות אסורות
מאמר - מאמר מרדכי
מביט - רבי משה בן יוסף טראני
מגג - מגן גיבורים 
מהדו - מהדורה 
מהדוג - מהדורה ג'
מהדות - מהדורה תניינא
מהרח – מורנו הרב רבי חיים (אליעזר בן יצחק מווינה, בעל 'אור זרוע')
מהרי (ברונא) - מורנו הרב רבי ישראל 
מהרי (ענגיל) - מורנו הרב רבי יוסף 
מהרל - מורנו הרב רבי ליוואי (מפראג)
מהרם מרוטנבורג - מורנו הרב רבי מאיר מרוטנבורג 
מהרם שיק - מורנו הרב רבי משה שיק
מהרש (קלוגר) – מורנו הרב רבי שלמה 
מהריו – מורנו הרב רבי יעקב בן יהודה (וייל)
מהריט - מורנו הרב רבי יוסף מטראני
מהריל - מורנו הרב רבי יעקב הלוי
מהריץ – מורנו הרב רבי יחיא צאלח
מהריק - מורנו הרב רבי יוסף קולון
מהריטץ - מורנו הרב רבי יום טוב צהלון
מהריקש - מורנו הרב רבי יעקב קאשטרו
מהרשא - מורנו הרב רבי שמואל אליעזר (הלוי אידלס)
מהרשג - מורנו הרב רבי שמעון גרינפלד
מהרשל - מורנו הרב רבי שלמה לוריא
מהרשם - מורנו הרב רבי שלום מרדכי (הכהן)
מוק - מועד קטן, מור וקציעה
מור - מורנו ורבנו, מורי ורבי 
מוצש - מוצאי שבת
מחבר - מחזיק ברכה
מחהש - מחצית השקל
מנחי - מנחת יצחק 
מנכל - מנהל כללי
מס - מסכת
מעיט - מעדני יום טוב
מקוח - מקור חיים 
מקוח לחווי - מקור חיים לחוות יאיר 
משבז - משבצות זהב 
נט - נותן טעם
נל - נראה לי
נמ - נפקא מינה 
נוב - נודע ביהודה
נוב מהדוק - נודע ביהודה מהדורה קמא
נלענד - נראה לעניות דעתי
נציב - הרב נפתלי צבי יהודה ברלין
נשא - נשמת אדם, נשמת אברהם
סמ - סנטימטר
סק - סעיף קטן 
סת – ספר תורה
סדבהנ – סדר ברכות הנהנין
סוס - סוף סימן 
סוס - סוף סימן, סוף ספר
סופ - סוף פרק
סודה – סוף דיבור המתחיל
סי - סימן
סכום - סכין, כף ומזלג
סמג - ספר מצוות גדול 
סמק - ספר מצוות קטן; סנטימטר מעוקב 
ספכ - סידור פסח כהלכתו
ע - עמוד, עיין
עז - עבודה זרה 
עכ - עד כאן 
עע - עיין עוד, עיין ערך
עפ - ערב פסח, על פי
עש - עיין שם 
עבוהק - עבודת הקודש
עהש - עלות השחר 
עוש - עולת שבת
עוהב - עולם הבא
עוהז - עולם הזה
עי - עיין
עיש - עיין שם
עמ - עמוד
עפי - על פי 
עפיז - על פי זה
ערוהש - ערוך השולחן
פ - פרק
פה - פניני הלכה, פרק ה
פת - פתחי תשובה
פהמש - פירוש המשנה
פמג - פרי מגדים 
פנהל - פניני הלכה
פסת - פסקי תשובות
פסודז - פסוקי דזמרה 
פרח - פרי חדש 
פרדרא - פרקי דרבי אליעזר
צע - צריך עיון 
צאהכ - צאת הכוכבים
צלח - ציון לנפש חיה 
קו - קל וחומר 
קש - קריאת שמע
קהר - קהלת רבה
קונא - קונטרס אחרון
קצושע - קיצור שלחן ערוך
קשג - קשר גודל
רא טירנא - רבי (יצחק) אייזיק מטירנא
רה - ראש השנה 
רח - רבנו חננאל, ראש חדש
רח פלאג'י - רבי חיים פלאג'י 
רן - רבנו נסים (גירונדי)
רפ - ראש פרק
רש משאנץ - רבי שמשון משאנץ
רת - רבנו תם
ראה - רבי אהרן הלוי
ראש - רבנו אשר (בן יחיאל)
ראבד - רבי אברהם בן דוד
ראבן - רבי אליעזר בן נתן
ראביה - רבי אליעזר בן יואל הלוי
רדבז - רבי דוד בן זמרא
רוהפ - רוב הפוסקים 
רזה - רבינו זרחיה הלוי
רחד הלוי - הרב חיים דוד הלוי
רחדה - הרב חיים דוד הלוי
ריד - רבי ישעיה (בן מאלי) די-טראני (סבו של הריאז)
ריו - רבנו יונה
ריו - רבנו ירוחם (בן משולם)
ריף - רבי יצחק אלפסי
ריץ (גיאת) - רבי יצחק בן רבי יהודה אבן גיאת
ריאז - רבי ישעיה (בן) אליה (די-טראני) זל (נכדו של הריד)
ריבא - רבי יצחק בן אשר (הלוי)
ריבם - רבי יצחק בן מרדכי
ריבש - רבי יצחק בן ששת
ריטבא - רבי יום טוב בן אברהם (אלאשׂבילי)
ריצבא - רבי יצחק בן אברהם
רישא - רבי יוסף שלום אלישיב
רמא - רבי משה איסרליש
רמע מפאנו - רבי מנחם עזריה
רמק - רבי משה קורדובירו
רמבם - רבי משה בן מימון
רמבן - רבי משה בן נחמן
רמחל - רבי משה חיים לוצאטו
רסג - רבנו סעדיה גאון
רעא - רבי עקיבא איגר
רעב - רבי עובדיה ברטנורא
רעמ - רעיא מהימנא
רציה - רבנו צבי יהודה הכהן (קוק)
רשי - רבי שלמה יצחק
רשל - רבי שלמה לוריא
רשש - ר' שלום שרעבי
רשבא - רבי שלמה בן אברהם
רשבי – רבי שמעון בר יוחאי
רשבם - רבי שמואל בן מאיר
רשזא - רבי שלמה זלמן אויערבך
שא - שנה א'
שב - שנה ב'
שך - שפתי כהן
שץ - שליח ציבור
שר - שנה ראשונה 
שש -  שנה שניה
שאגא - שאגת אריה
שבהל - שבולי הלקט
שבוי - שבות יעקב
שהג - שלטי הגבורים 
שהג (שלטג) - שלטי הגבורים
שהשר - שיר השירים רבה
שומ - שואל ומשיב
שוע - שולחן ערוך
שות - שאלות ותשובות
שועהר - שולחן ערוך הרב
שכנהג - שיירי כנסת הגדולה
שלה - שני לוחות הברית
שליטא - שיחיה לאורך ימים טובים, אמן
שמהכ - שמירת המועד כהלכתו 
שמוא - שמואל א'
שעת - שערי תשובה
שעהד - שעת הדחק
שעהצ - שער הציון
ששכ - שמירת שבת כהלכתה
תז - תיקוני זוהר
תח - תלמיד חכם 
תק - תנא קמא
תת - תלמוד תורה
תדבאר - תנא דבי אליהו רבה
תהד - תרומת הדשן
תהלד - תהילה לדוד
תוכ - תורת כהנים 
תוהמ - תורת המועדים
תוס - תוספות
תנך - תורה נביאים כתובים
תרי - תלמידי רבינו יונה
תרת - תקיעה תרועה תקיעה.
תשת - תקיעה שברים תקיעה.
תשבץ - תשובות רבי שמעון בן צמח (דוראן)
תשרת - תקיעה שברים תרועה תקיעה.
